Geography,total_2008,native_2008,state_native_2008,foreign_born_est_2008,foreign_born_est_no_citizen_2008,precent_foreign_born_2008,percent_born_out_of_state_2008
"Baldwin County, Alabama",174439,169677,95796,4762,2811,0.027298941,0.450833816
"Calhoun County, Alabama",113419,110953,84450,2466,1611,0.021742389,0.255415759
"Cullman County, Alabama",81324,78045,59707,3279,2816,0.040320201,0.26581329
"DeKalb County, Alabama",68515,64471,45752,4044,3941,0.059023571,0.332233817
"Elmore County, Alabama",78106,76578,57178,1528,1289,0.019563158,0.267943564
"Etowah County, Alabama",103303,101308,83028,1995,1449,0.019312121,0.196267291
"Houston County, Alabama",98488,97049,69001,1439,1022,0.014610917,0.299396881
"Jefferson County, Alabama",659503,637038,499428,22465,15418,0.03406353,0.242720655
"Lauderdale County, Alabama",89128,85748,65385,3380,3191,0.037922987,0.266392155
"Lee County, Alabama",133010,128141,71599,4869,3903,0.03660627,0.461702128
"Limestone County, Alabama",76135,72603,53539,3532,2587,0.046391279,0.296788599
"Madison County, Alabama",319510,303535,171608,15975,9019,0.049998435,0.46290257
"Marshall County, Alabama",88484,83024,60872,5460,4966,0.061706071,0.312056417
"Mobile County, Alabama",406309,394444,300356,11865,6985,0.029201913,0.260769513
"Montgomery County, Alabama",224810,218981,167288,5829,3250,0.025928562,0.255869401
"Morgan County, Alabama",115959,111630,79776,4329,3544,0.037332161,0.312032701
"St. Clair County, Alabama",79577,78466,63999,1111,850,0.01396132,0.195760081
"Shelby County, Alabama",187784,178740,119219,9044,6904,0.048161718,0.365126954
"Talladega County, Alabama",80279,79482,65358,797,389,0.009927877,0.185864298
"Tuscaloosa County, Alabama",179448,175220,134922,4228,2413,0.023561143,0.248127591
"Walker County, Alabama",68970,68573,56615,397,269,0.005756126,0.179135856
"Anchorage Municipality, Alaska",279243,255779,92591,23464,9920,0.084027173,0.668421411
"Fairbanks North Star Borough, Alaska",97970,92980,32195,4990,2260,0.050933959,0.671378994
"Matanuska-Susitna Borough, Alaska",85458,83646,30093,1812,889,0.021203398,0.647862108
"Apache County, Arizona",70207,69064,51809,1143,566,0.016280428,0.262053641
"Cochise County, Arizona",129006,113096,43338,15910,7797,0.123327597,0.664062137
"Coconino County, Arizona",128558,121574,69217,6984,5314,0.054325674,0.461589322
"Maricopa County, Arizona",3954598,3303527,1366673,651071,472599,0.164636456,0.654409121
"Mohave County, Arizona",196281,185455,31444,10826,5905,0.055155619,0.839801101
"Navajo County, Arizona",112757,108795,74711,3962,2964,0.035137508,0.337415859
"Pima County, Arizona",1012018,882128,391883,129890,80144,0.12834752,0.612770721
"Pinal County, Arizona",327301,295503,134108,31798,21380,0.097152163,0.590260952
"Yavapai County, Arizona",215503,199415,64330,16088,10170,0.074653253,0.701489074
"Yuma County, Arizona",194322,151084,65489,43238,29480,0.222506973,0.662987207
"Benton County, Arkansas",209791,193157,79307,16634,10291,0.079288435,0.621971391
"Craighead County, Arkansas",92640,92242,63083,398,87,0.0042962,0.319052245
"Faulkner County, Arkansas",106823,102531,67302,4292,3924,0.040178613,0.369967142
"Garland County, Arkansas",97465,93065,53259,4400,2190,0.045144411,0.453557687
"Jefferson County, Arkansas",78373,77372,58793,1001,592,0.012772256,0.249830937
"Lonoke County, Arkansas",65233,64619,41507,614,337,0.009412414,0.363711618
"Pulaski County, Arkansas",376797,358705,248688,18092,11267,0.048015244,0.339994745
"Saline County, Arkansas",98209,95387,65357,2822,1520,0.028734637,0.334511094
"Sebastian County, Arkansas",122274,112784,67961,9490,6553,0.077612575,0.444190915
"Washington County, Arkansas",195803,178085,101433,17718,11585,0.09048891,0.481964015
"White County, Arkansas",74845,73597,46632,1248,1021,0.016674461,0.376952368
"Alameda County, California",1474368,1036511,739439,437857,205692,0.296979452,0.498470531
"Butte County, California",220337,200584,152354,19753,10549,0.089649038,0.308541008
"Contra Costa County, California",1029703,781120,566881,248583,124077,0.24141233,0.449471352
"El Dorado County, California",176075,161630,112798,14445,7750,0.082038904,0.359375266
"Fresno County, California",909153,718764,593584,190389,133045,0.209413597,0.347102193
"Humboldt County, California",129000,123571,88598,5429,2641,0.042085271,0.313193798
"Imperial County, California",163972,111423,91922,52549,30661,0.320475447,0.439404289
"Kern County, California",800458,644520,507159,155938,106301,0.194810971,0.366413978
"Kings County, California",149518,118867,87829,30651,22552,0.204998729,0.412585776
"Lake County, California",64866,59923,40824,4943,3771,0.07620325,0.370641014
"Los Angeles County, California",9862049,6391731,4813507,3470318,1922442,0.351886104,0.511916134
"Madera County, California",148333,117711,96264,30622,24531,0.206440913,0.351027755
"Marin County, California",248794,204133,119413,44661,21807,0.179509956,0.520032637
"Mendocino County, California",86221,75550,55420,10671,6463,0.123763352,0.357233157
"Merced County, California",246117,185234,153023,60883,42943,0.247374216,0.378250994
"Monterey County, California",408238,282740,207056,125498,87698,0.307413813,0.492805667
"Napa County, California",133433,101889,73594,31544,21786,0.236403289,0.448457278
"Nevada County, California",97118,92302,62885,4816,2542,0.04958916,0.352488725
"Orange County, California",3010759,2106494,1507716,904265,490806,0.300344531,0.49922395
"Placer County, California",341945,308855,213347,33090,17153,0.096769948,0.376078024
"Riverside County, California",2100516,1631298,1193705,469218,293072,0.223382255,0.431708685
"Sacramento County, California",1394154,1122344,822968,271810,141307,0.194964114,0.409700793
"San Bernardino County, California",2015355,1590046,1228943,425309,251324,0.211034284,0.390210161
"San Diego County, California",3001072,2338544,1440349,662528,343298,0.22076378,0.520055167
"San Francisco County, California",808976,525683,313410,283293,109622,0.35018715,0.612584304
"San Joaquin County, California",672388,519337,414162,153051,86872,0.227623039,0.384043142
"San Luis Obispo County, California",265297,234605,171933,30692,17627,0.115689209,0.351922562
"San Mateo County, California",712690,468760,339270,243930,113693,0.342266624,0.523958523
"Santa Barbara County, California",405396,313485,213951,91911,63622,0.22671906,0.472241956
"Santa Clara County, California",1764499,1114746,800681,649753,327870,0.368236536,0.546227569
"Santa Cruz County, California",253137,205853,148309,47284,31981,0.186792132,0.414115676
"Shasta County, California",180214,172238,126351,7976,4471,0.044258493,0.29888355
"Solano County, California",407515,326495,222904,81020,42001,0.198814768,0.453016453
"Sonoma County, California",466741,387176,284471,79565,51825,0.170469275,0.390516368
"Stanislaus County, California",510694,413858,330780,96836,59289,0.189616483,0.352293154
"Sutter County, California",92207,72277,55519,19930,11988,0.216144111,0.397887362
"Tulare County, California",426276,330969,278009,95307,65992,0.223580497,0.347819253
"Ventura County, California",797740,620198,438371,177542,104311,0.222556221,0.450483867
"Yolo County, California",197658,155074,117690,42584,22645,0.215442836,0.404577604
"Yuba County, California",73067,64252,45557,8815,5261,0.120642698,0.376503757
"Adams County, Colorado",430836,363979,219137,66857,48855,0.155179697,0.491367945
"Arapahoe County, Colorado",554282,474902,217167,79380,52806,0.1432123,0.608201241
"Boulder County, Colorado",293161,260561,89867,32600,22766,0.111201695,0.693455132
"Denver County, Colorado",598707,490573,252693,108134,78890,0.180612553,0.577935451
"Douglas County, Colorado",280621,263801,100882,16820,7922,0.059938494,0.640504453
"El Paso County, Colorado",596053,554247,183191,41806,21988,0.070138058,0.692659881
"Jefferson County, Colorado",533339,495845,249322,37494,22128,0.070300503,0.532526217
"Larimer County, Colorado",292825,275657,111836,17168,10692,0.058628874,0.618079057
"Mesa County, Colorado",143171,138508,69683,4663,2707,0.032569445,0.513288306
"Pueblo County, Colorado",156737,151847,100673,4890,3078,0.03119876,0.357694737
"Weld County, Colorado",249775,224450,128991,25325,18103,0.101391252,0.483571214
"Fairfield County, Connecticut",895030,709311,374168,185719,109496,0.207500307,0.581949208
"Hartford County, Connecticut",877312,761611,509048,115701,60368,0.131881246,0.419764006
"Litchfield County, Connecticut",187745,176860,128765,10885,4587,0.057977576,0.314149511
"Middlesex County, Connecticut",164794,154056,103839,10738,5118,0.065160139,0.36988604
"New Haven County, Connecticut",846101,752730,529565,93371,50118,0.110354438,0.374111365
"New London County, Connecticut",264519,244901,143072,19618,9341,0.074164805,0.459123919
"Tolland County, Connecticut",148406,137110,89394,11296,5903,0.076115521,0.397638909
"Windham County, Connecticut",117345,110671,66874,6674,3766,0.056875027,0.430107802
"Kent County, Delaware",155415,149014,76112,6401,3140,0.041186501,0.510266062
"New Castle County, Delaware",529641,479149,251294,50492,31433,0.095332499,0.525538997
"Sussex County, Delaware",188036,178136,79621,9900,6542,0.052649493,0.576565126
"District of Columbia, District of Columbia",591833,513949,238285,77884,50663,0.131597934,0.597377977
"Alachua County, Florida",241364,219937,118127,21427,12673,0.088774631,0.510585671
"Bay County, Florida",163946,156437,61941,7509,3707,0.045801666,0.622186574
"Brevard County, Florida",536521,492529,159103,43992,17572,0.081994927,0.703454292
"Broward County, Florida",1751234,1232269,548693,518965,275860,0.296342465,0.686682077
"Charlotte County, Florida",150060,137112,34876,12948,4559,0.086285486,0.767586299
"Citrus County, Florida",141416,133659,41426,7757,1157,0.054852351,0.70706285
"Clay County, Florida",184727,175235,77335,9492,3784,0.051383934,0.581355189
"Collier County, Florida",315258,243783,66604,71475,48558,0.226719068,0.788731769
"Columbia County, Florida",72124,69567,40395,2557,1589,0.035452831,0.439922911
"Duval County, Florida",850962,783003,410915,67959,34668,0.07986138,0.517117098
"Escambia County, Florida",302939,290558,133626,12381,5543,0.040869614,0.558901297
"Flagler County, Florida",91247,81171,18887,10076,3775,0.110425548,0.793012373
"Hernando County, Florida",171689,158739,49248,12950,4163,0.07542708,0.713155764
"Highlands County, Florida",100011,90690,34566,9321,5653,0.093199748,0.654378018
"Hillsborough County, Florida",1180784,1010393,467435,170391,93328,0.144303276,0.604131662
"Indian River County, Florida",132315,117401,42768,14914,8735,0.112715867,0.676771341
"Lake County, Florida",307243,284389,99156,22854,10360,0.074384119,0.677271736
"Lee County, Florida",593136,503748,145464,89388,55480,0.150704054,0.75475439
"Leon County, Florida",264063,248357,141182,15706,9016,0.059478231,0.465347285
"Manatee County, Florida",315766,281621,98126,34145,22158,0.108133871,0.689244567
"Marion County, Florida",329628,302515,112160,27113,9930,0.082253328,0.659737644
"Martin County, Florida",138660,125714,37970,12946,6562,0.093365066,0.726164719
"Miami-Dade County, Florida",2398245,1202633,792101,1195612,590401,0.498536221,0.669716397
"Monroe County, Florida",72243,60148,22183,12095,6507,0.167421065,0.692939108
"Nassau County, Florida",69835,68460,39752,1375,429,0.019689268,0.430772535
"Okaloosa County, Florida",179693,163966,55326,15727,8204,0.087521495,0.692108207
"Orange County, Florida",1072801,868040,343242,204761,116762,0.19086578,0.680050634
"Osceola County, Florida",263676,213639,60980,50037,28077,0.189766987,0.768731322
"Palm Beach County, Florida",1265293,984833,344428,280460,162683,0.22165617,0.727787951
"Pasco County, Florida",471028,429786,145197,41242,18663,0.087557428,0.69174444
"Pinellas County, Florida",910260,815195,267867,95065,47701,0.104437194,0.705724738
"Polk County, Florida",580594,517775,246227,62819,40055,0.108197811,0.575905021
"Putnam County, Florida",73459,69697,40343,3762,3303,0.051212241,0.450809295
"St. Johns County, Florida",181540,171712,64178,9828,4141,0.054136829,0.646480115
"St. Lucie County, Florida",265108,226607,88320,38501,22692,0.145227605,0.666852754
"Santa Rosa County, Florida",150053,144141,57768,5912,2799,0.039399412,0.615016028
"Sarasota County, Florida",372057,332435,83419,39622,21624,0.106494435,0.775789731
"Seminole County, Florida",410854,364561,139107,46293,23092,0.112675062,0.661419872
"Sumter County, Florida",74721,71718,30545,3003,2445,0.040189505,0.591212644
"Volusia County, Florida",498036,461429,166968,36607,15911,0.073502719,0.664747127
"Barrow County, Georgia",64349,60837,43392,3512,2286,0.054577383,0.325677167
"Bartow County, Georgia",94913,90372,62455,4541,2861,0.047843815,0.341976336
"Bibb County, Georgia",155216,150088,112578,5128,2819,0.033037831,0.274701062
"Bulloch County, Georgia",67761,66009,50700,1752,1552,0.025855581,0.251781998
"Carroll County, Georgia",113688,108976,78888,4712,3980,0.041446767,0.306100908
"Chatham County, Georgia",251120,239592,151570,11528,8002,0.04590634,0.39642402
"Cherokee County, Georgia",210529,192145,97411,18384,10392,0.087322887,0.537303649
"Clarke County, Georgia",114737,101915,65350,12822,9378,0.111751222,0.430436564
"Clayton County, Georgia",273718,240611,135274,33107,21983,0.120952952,0.505790631
"Cobb County, Georgia",698158,596932,264996,101226,63668,0.144990103,0.620435489
"Columbia County, Georgia",110627,104038,56751,6589,2886,0.059560505,0.487005885
"Coweta County, Georgia",122924,117116,73016,5808,3929,0.047248707,0.406006964
"DeKalb County, Georgia",739956,611208,325095,128748,85100,0.173994129,0.560656309
"Dougherty County, Georgia",95754,94738,76042,1016,276,0.010610523,0.205860852
"Douglas County, Georgia",127932,116933,63032,10999,7847,0.085975362,0.507300754
"Fayette County, Georgia",106465,98843,40315,7622,3862,0.071591603,0.621330954
"Floyd County, Georgia",95980,89415,68472,6565,5663,0.068399667,0.286601375
"Forsyth County, Georgia",168060,145733,69532,22327,13220,0.132851363,0.586266809
"Fulton County, Georgia",1014932,884991,467958,129941,91343,0.128029267,0.538926746
"Glynn County, Georgia",75884,73638,44036,2246,1646,0.029597807,0.419693216
"Gwinnett County, Georgia",789499,589361,276479,200138,123860,0.253500004,0.649804496
"Hall County, Georgia",184814,152953,106149,31861,26366,0.172394948,0.425644161
"Henry County, Georgia",191502,180374,108179,11128,5110,0.058109054,0.435102505
"Houston County, Georgia",133161,127406,72796,5755,2973,0.04321836,0.453323421
"Lowndes County, Georgia",104583,101218,64392,3365,2175,0.032175401,0.384297639
"Muscogee County, Georgia",186984,179822,97083,7162,3232,0.038302742,0.480795148
"Newton County, Georgia",98542,91909,59907,6633,2125,0.0673114,0.392066327
"Paulding County, Georgia",133135,128573,79115,4562,2691,0.034265971,0.405753558
"Richmond County, Georgia",199486,192260,117741,7226,3684,0.036223093,0.40977813
"Rockdale County, Georgia",83222,74387,39868,8835,5995,0.106161832,0.520943981
"Walton County, Georgia",85813,81810,62916,4003,3188,0.046647944,0.266824374
"Whitfield County, Georgia",93835,77206,53766,16629,13284,0.177215325,0.427015506
"Hawaii County, Hawaii",175784,152182,92975,23602,15826,0.134267055,0.47108383
"Honolulu County, Hawaii",905034,732568,480768,172466,76806,0.190563006,0.468784598
"Maui County, Hawaii",143641,118745,70550,24896,11841,0.173320988,0.508844968
"Ada County, Idaho",380920,354206,157424,26714,16951,0.070130211,0.586726872
"Bannock County, Idaho",80812,78801,50007,2011,968,0.024884918,0.381193387
"Bonneville County, Idaho",99135,95400,56214,3735,2492,0.037675897,0.432955061
"Canyon County, Idaho",183939,168171,89396,15768,12197,0.085724072,0.513991051
"Kootenai County, Idaho",137475,133321,45012,4154,1981,0.030216403,0.672580469
"Twin Falls County, Idaho",75613,70310,41124,5303,3952,0.070133443,0.456125269
"Adams County, Illinois",66897,66304,52678,593,384,0.008864374,0.212550638
"Champaign County, Illinois",193636,173145,129182,20491,14984,0.105822264,0.332861658
"Cook County, Illinois",5294664,4177330,3272606,1117334,611966,0.211030199,0.381904876
"DeKalb County, Illinois",106321,99054,80419,7267,4987,0.06834962,0.243620733
"DuPage County, Illinois",930528,763975,587154,166553,79007,0.178987629,0.369009852
"Kane County, Illinois",507579,420577,325046,87002,59252,0.17140583,0.359614956
"Kankakee County, Illinois",112524,109259,91788,3265,2198,0.029016032,0.184280687
"Kendall County, Illinois",103460,94260,72319,9200,4627,0.088923255,0.300995554
"Lake County, Illinois",712453,572431,412599,140022,81986,0.19653507,0.420875482
"LaSalle County, Illinois",112474,107479,90943,4995,3547,0.044410264,0.191430908
"McHenry County, Illinois",318641,288446,226884,30195,16109,0.094761817,0.28796357
"McLean County, Illinois",165298,159064,124434,6234,4794,0.037713705,0.247214122
"Macon County, Illinois",108328,106732,85823,1596,1167,0.014733033,0.207748689
"Madison County, Illinois",268078,263609,186328,4469,1645,0.016670521,0.30494856
"Peoria County, Illinois",183655,175527,137019,8128,3625,0.044256895,0.253932645
"Rock Island County, Illinois",146886,135142,89902,11744,8260,0.079953161,0.387947115
"St. Clair County, Illinois",262291,254917,150458,7374,3988,0.028113813,0.426369948
"Sangamon County, Illinois",194925,189691,154173,5234,1473,0.026851353,0.209065025
"Tazewell County, Illinois",131524,129833,103410,1691,480,0.012856969,0.213755664
"Vermilion County, Illinois",80680,79347,64352,1333,897,0.016522062,0.202379772
"Will County, Illinois",681097,594960,490993,86137,47726,0.126468036,0.279114429
"Winnebago County, Illinois",300252,278958,203373,21294,12311,0.070920427,0.322658966
"Allen County, Indiana",350523,331430,236936,19093,11643,0.054470035,0.324050062
"Bartholomew County, Indiana",75360,70979,53879,4381,3799,0.058134289,0.285045117
"Clark County, Indiana",106673,104147,50053,2526,1606,0.023679844,0.530780985
"Delaware County, Indiana",114685,112770,84593,1915,1019,0.016697912,0.262388281
"Elkhart County, Indiana",199137,182155,126485,16982,11610,0.085277974,0.36483426
"Floyd County, Indiana",73780,72691,41449,1089,743,0.014760098,0.438208187
"Grant County, Indiana",68609,67080,50787,1529,675,0.022285706,0.259761839
"Hamilton County, Indiana",269785,255334,154092,14451,7856,0.053564876,0.428834072
"Hancock County, Indiana",67282,66338,51269,944,419,0.014030498,0.237998276
"Hendricks County, Indiana",137240,133476,90727,3764,1619,0.027426406,0.338917225
"Howard County, Indiana",83381,82216,61971,1165,431,0.013972008,0.256773126
"Johnson County, Indiana",139158,135988,100433,3170,1621,0.022779862,0.278280803
"Kosciusko County, Indiana",76275,72788,54554,3487,2589,0.045716159,0.284772206
"Lake County, Indiana",493800,465868,275811,27932,12154,0.056565411,0.441452005
"LaPorte County, Indiana",110888,107352,77880,3536,1730,0.031888031,0.297669721
"Madison County, Indiana",131501,129556,105346,1945,1114,0.014790762,0.198895826
"Marion County, Indiana",880380,821540,590880,58840,43126,0.066834776,0.328835276
"Monroe County, Indiana",128992,121476,78749,7516,5634,0.058267179,0.389504775
"Morgan County, Indiana",70668,69531,57651,1137,702,0.016089319,0.184199355
"Porter County, Indiana",162181,155789,104715,6392,2295,0.039412755,0.354332505
"St. Joseph County, Indiana",266680,251706,172733,14974,10072,0.056149693,0.352283636
"Tippecanoe County, Indiana",164237,147362,100344,16875,13836,0.102747858,0.389029269
"Vanderburgh County, Indiana",174729,171597,127803,3132,1906,0.017924901,0.268564463
"Vigo County, Indiana",105968,103650,81290,2318,1472,0.021874528,0.232881625
"Wayne County, Indiana",67795,66936,47022,859,233,0.012670551,0.306409027
"Black Hawk County, Iowa",128347,123096,99571,5251,3080,0.040912526,0.224204695
"Dubuque County, Iowa",92724,91670,75285,1054,609,0.011367068,0.188074285
"Johnson County, Iowa",128094,118235,75786,9859,7058,0.076966915,0.408356363
"Linn County, Iowa",208574,201590,153848,6984,3542,0.033484519,0.262381697
"Polk County, Iowa",424778,394697,293848,30081,17235,0.070815814,0.308231594
"Pottawattamie County, Iowa",89647,86670,50892,2977,1888,0.033208027,0.432306714
"Scott County, Iowa",164690,158171,107362,6519,4415,0.03958346,0.348096424
"Story County, Iowa",86754,80117,55185,6637,5165,0.076503677,0.363891002
"Woodbury County, Iowa",102559,95986,66766,6573,4654,0.064089938,0.348999113
"Douglas County, Kansas",114748,108056,63466,6692,4300,0.058319099,0.44690975
"Johnson County, Kansas",534093,489688,208223,44405,24164,0.083140951,0.610137186
"Leavenworth County, Kansas",75946,73893,38090,2053,1602,0.027032365,0.498459432
"Riley County, Kansas",71069,67332,34296,3737,2451,0.052582701,0.517426726
"Sedgwick County, Kansas",482863,450884,306945,31979,17919,0.066227895,0.3643228
"Shawnee County, Kansas",174709,167299,115858,7410,5169,0.042413385,0.336851565
"Wyandotte County, Kansas",154287,136044,83205,18243,14943,0.118240681,0.460712827
"Boone County, Kentucky",115231,111186,59308,4045,2342,0.035103401,0.485312112
"Bullitt County, Kentucky",75028,74231,60791,797,396,0.010622701,0.189755824
"Campbell County, Kentucky",87038,85714,58426,1324,1085,0.015211747,0.32872998
"Christian County, Kentucky",79820,78479,39192,1341,887,0.016800301,0.508995239
"Daviess County, Kentucky",94418,92878,77302,1540,721,0.016310449,0.181278993
"Fayette County, Kentucky",282114,259913,177494,22201,16341,0.078695137,0.370842993
"Hardin County, Kentucky",98546,95109,49947,3437,1269,0.034877113,0.493160554
"Jefferson County, Kentucky",713877,676085,507191,37792,24349,0.052939092,0.289526067
"Kenton County, Kentucky",157629,153843,96877,3786,2722,0.024018423,0.385411314
"McCracken County, Kentucky",65109,64019,38642,1090,543,0.016741157,0.406502941
"Madison County, Kentucky",82192,81087,59071,1105,652,0.013444131,0.28130475
"Pike County, Kentucky",65331,64671,50144,660,419,0.010102402,0.232462384
"Warren County, Kentucky",105862,97568,62561,8294,6659,0.078347282,0.409032514
"Ascension Parish, Louisiana",101789,99922,82121,1867,1229,0.018341864,0.193223236
"Bossier Parish, Louisiana",110250,105446,67817,4804,3196,0.043573696,0.384879819
"Caddo Parish, Louisiana",252895,248713,193860,4182,1909,0.016536507,0.233436802
"Calcasieu Parish, Louisiana",185618,183234,145919,2384,1549,0.012843582,0.213874732
"East Baton Rouge Parish, Louisiana",428360,409350,329469,19010,11114,0.04437856,0.230859557
"Iberia Parish, Louisiana",75097,74487,66930,610,411,0.008122828,0.10875268
"Jefferson Parish, Louisiana",436181,397965,333945,38216,17946,0.087615004,0.234388935
"Lafayette Parish, Louisiana",206976,201503,166472,5473,3129,0.026442679,0.195694187
"Lafourche Parish, Louisiana",92572,91624,83473,948,740,0.010240678,0.09829106
"Livingston Parish, Louisiana",120256,119454,94242,802,553,0.006669106,0.216321847
"Orleans Parish, Louisiana",311853,295342,237150,16511,9040,0.052944817,0.239545555
"Ouachita Parish, Louisiana",150051,148535,122940,1516,883,0.010103232,0.180678569
"Rapides Parish, Louisiana",133131,130647,105945,2484,1419,0.018658314,0.204204881
"St. Landry Parish, Louisiana",92173,91405,85243,768,397,0.008332158,0.075184707
"St. Tammany Parish, Louisiana",228456,220517,164678,7939,3765,0.034750674,0.279169731
"Tangipahoa Parish, Louisiana",117001,114802,95184,2199,1674,0.018794711,0.186468492
"Terrebonne Parish, Louisiana",108576,106127,93863,2449,1406,0.022555629,0.135508768
"Androscoggin County, Maine",106877,104453,77706,2424,1170,0.022680277,0.272939922
"Aroostook County, Maine",71676,67305,51972,4371,1365,0.060982756,0.274903733
"Cumberland County, Maine",276047,262658,161189,13389,6667,0.04850261,0.416081319
"Kennebec County, Maine",120959,118638,84167,2321,717,0.01918832,0.304169181
"Penobscot County, Maine",148651,144579,106201,4072,2329,0.027393021,0.28556821
"York County, Maine",201686,196225,99804,5461,1981,0.027076743,0.505151572
"Allegany County, Maryland",72238,71055,52561,1183,496,0.016376422,0.272391262
"Anne Arundel County, Maryland",512790,475882,269163,36908,17681,0.071974883,0.475100919
"Baltimore County, Maryland",785618,712398,517118,73220,38077,0.093200512,0.341769155
"Calvert County, Maryland",88698,85699,45570,2999,1037,0.03381136,0.486234188
"Carroll County, Maryland",169353,163989,117447,5364,2587,0.031673487,0.306495899
"Cecil County, Maryland",99926,98230,51984,1696,453,0.01697256,0.479775034
"Charles County, Maryland",140764,134785,57810,5979,2342,0.042475349,0.589312608
"Frederick County, Maryland",225721,206973,110977,18748,12003,0.083058289,0.508344372
"Harford County, Maryland",240351,230117,160502,10234,5160,0.042579394,0.332218297
"Howard County, Maryland",274995,230735,112719,44260,18623,0.160948381,0.590105275
"Montgomery County, Maryland",950680,663273,221984,287407,150883,0.302317289,0.766499769
"Prince George's County, Maryland",820852,669027,192007,151825,93233,0.184960261,0.766088162
"St. Mary's County, Maryland",101578,98356,49148,3222,1486,0.031719467,0.516155073
"Washington County, Maryland",145384,140727,96363,4657,2025,0.032032411,0.337182909
"Wicomico County, Maryland",94046,90406,60304,3640,2285,0.038704464,0.358781873
"Baltimore city, Maryland",636919,599598,441405,37321,21668,0.058596148,0.30696839
"Barnstable County, Massachusetts",221049,208385,142767,12664,5270,0.057290465,0.354138675
"Berkshire County, Massachusetts",129395,124076,90544,5319,2738,0.041106689,0.300251169
"Bristol County, Massachusetts",545823,481555,372602,64268,23846,0.11774513,0.317357458
"Essex County, Massachusetts",736457,629840,490970,106617,55147,0.144770163,0.333335144
"Franklin County, Massachusetts",71735,69363,49099,2372,706,0.033066146,0.315550289
"Hampden County, Massachusetts",460840,421809,297142,39031,18657,0.084695339,0.355216561
"Hampshire County, Massachusetts",154983,143662,96055,11321,6196,0.073046721,0.380222347
"Middlesex County, Massachusetts",1482478,1214590,868816,267888,141971,0.18070285,0.413943411
"Norfolk County, Massachusetts",659909,561339,420463,98570,42133,0.14936908,0.362846999
"Plymouth County, Massachusetts",492066,455697,380483,36369,16033,0.073910817,0.226764296
"Suffolk County, Massachusetts",732684,527304,351602,205380,118348,0.28031184,0.520117813
"Worcester County, Massachusetts",783806,698371,547765,85435,46167,0.109000186,0.301147223
"Allegan County, Michigan",112975,109152,92153,3823,2431,0.033839345,0.184306262
"Bay County, Michigan",107495,105930,97486,1565,488,0.014558817,0.093111308
"Berrien County, Michigan",159481,150806,93262,8675,5147,0.054395194,0.415215606
"Calhoun County, Michigan",135861,130634,107563,5227,3277,0.038473145,0.20828641
"Clinton County, Michigan",69726,68826,60594,900,456,0.012907667,0.130969796
"Eaton County, Michigan",106781,103495,86761,3286,1882,0.030773265,0.187486538
"Genesee County, Michigan",428790,416477,347744,12313,4603,0.028715688,0.189010938
"Grand Traverse County, Michigan",86071,84714,70150,1357,508,0.015766054,0.184975195
"Ingham County, Michigan",277528,255849,201045,21679,14401,0.078114641,0.275586607
"Isabella County, Michigan",66778,65153,56559,1625,742,0.024334362,0.153029441
"Jackson County, Michigan",160180,157609,130310,2571,1300,0.016050693,0.186477713
"Kalamazoo County, Michigan",245912,235284,181571,10628,6810,0.043218712,0.261642376
"Kent County, Michigan",605213,563508,453507,41705,26677,0.068909624,0.250665468
"Lapeer County, Michigan",90875,88834,77353,2041,839,0.022459422,0.148797799
"Lenawee County, Michigan",100801,96582,72406,4219,3600,0.041854744,0.281693634
"Livingston County, Michigan",182575,176291,142929,6284,2812,0.034418732,0.217149117
"Macomb County, Michigan",830663,751558,658632,79105,32950,0.095231159,0.207100834
"Marquette County, Michigan",65492,64775,50551,717,263,0.010947902,0.228134734
"Midland County, Michigan",82605,78931,62201,3674,1468,0.044476727,0.24700684
"Monroe County, Michigan",152949,150746,89645,2203,1021,0.014403494,0.413889597
"Muskegon County, Michigan",174344,171715,146751,2629,1150,0.015079383,0.158267563
"Oakland County, Michigan",1202174,1079719,866465,122455,55676,0.101861295,0.279251589
"Ottawa County, Michigan",260364,246328,204922,14036,7086,0.053909143,0.212940345
"Saginaw County, Michigan",200745,196375,168152,4370,2493,0.021768911,0.162360208
"St. Clair County, Michigan",168894,164662,147072,4232,1584,0.025057136,0.1292053
"Shiawassee County, Michigan",70880,69704,61981,1176,258,0.016591422,0.125550226
"Van Buren County, Michigan",77801,74584,53225,3217,2183,0.041349083,0.315882829
"Washtenaw County, Michigan",347376,308632,208460,38744,22929,0.111533324,0.399900972
"Wayne County, Michigan",1949929,1798856,1443176,151073,74607,0.077476154,0.259882796
"Anoka County, Minnesota",327090,303050,239719,24040,14248,0.073496591,0.267116084
"Carver County, Minnesota",90043,85823,58804,4220,1922,0.046866497,0.346934243
"Dakota County, Minnesota",392755,362425,255121,30330,15289,0.077223715,0.350432203
"Hennepin County, Minnesota",1140988,1007833,679200,133155,79021,0.11670149,0.40472643
"Olmsted County, Minnesota",141360,129258,85043,12102,6093,0.085611205,0.398394171
"Ramsey County, Minnesota",501428,442037,322145,59391,32123,0.118443725,0.357544852
"St. Louis County, Minnesota",196864,193208,155167,3656,1499,0.018571196,0.21180612
"Scott County, Minnesota",128937,120500,89182,8437,3532,0.065435057,0.308328874
"Sherburne County, Minnesota",87660,85573,68714,2087,776,0.023807894,0.216130504
"Stearns County, Minnesota",147076,141834,119420,5242,2590,0.035641437,0.188038837
"Washington County, Minnesota",229173,215010,157058,14163,6334,0.061800474,0.31467494
"Wright County, Minnesota",119701,117503,96235,2198,913,0.01836242,0.196038463
"DeSoto County, Mississippi",154748,149090,38308,5658,4227,0.03656267,0.752449143
"Forrest County, Mississippi",79425,77132,58972,2293,1848,0.028870003,0.257513377
"Harrison County, Mississippi",178460,171294,94839,7166,4089,0.040154657,0.468569988
"Hinds County, Mississippi",247650,241898,204145,5752,4037,0.023226327,0.17567131
"Jackson County, Mississippi",130694,125199,75461,5495,3158,0.042044776,0.422613127
"Jones County, Mississippi",67764,66086,55513,1678,1543,0.024762411,0.18078921
"Lauderdale County, Mississippi",78180,77241,56388,939,685,0.012010744,0.278741366
"Lee County, Mississippi",81139,80292,59418,847,406,0.010438876,0.267701106
"Madison County, Mississippi",91369,88233,65416,3136,2138,0.034322363,0.284046011
"Rankin County, Mississippi",140901,138500,103607,2401,1468,0.017040333,0.264682295
"Boone County, Missouri",154365,146486,95453,7879,4931,0.051041363,0.381640916
"Buchanan County, Missouri",89408,88095,63952,1313,688,0.014685487,0.284717251
"Cape Girardeau County, Missouri",73243,72413,54541,830,229,0.011332141,0.255341807
"Cass County, Missouri",98429,96571,58519,1858,1179,0.018876551,0.405469933
"Christian County, Missouri",75479,74601,41848,878,538,0.011632375,0.445567641
"Clay County, Missouri",215707,204469,124526,11238,7044,0.052098448,0.422707654
"Cole County, Missouri",74313,72115,55109,2198,1473,0.029577597,0.258420465
"Franklin County, Missouri",100898,99947,81974,951,385,0.00942536,0.187555749
"Greene County, Missouri",266944,258238,156046,8706,4618,0.032613582,0.415435447
"Jackson County, Missouri",668417,630269,401481,38148,24485,0.057072157,0.399355492
"Jasper County, Missouri",116813,112322,71396,4491,3307,0.038446063,0.388800904
"Jefferson County, Missouri",217679,213580,173741,4099,2100,0.01883048,0.201847675
"Platte County, Missouri",85896,82670,42892,3226,1930,0.037557046,0.500651951
"St. Charles County, Missouri",349407,338808,243566,10599,4639,0.030334252,0.302916084
"St. Louis County, Missouri",991830,932186,681877,59644,30882,0.060135305,0.312506175
"St. Louis city, Missouri",354361,329860,244469,24501,16681,0.069141356,0.310113133
"Cascade County, Montana",82026,80242,46037,1784,684,0.021749201,0.438751128
"Flathead County, Montana",88473,84552,40803,3921,2629,0.044318606,0.53880845
"Gallatin County, Montana",91791,88931,35019,2860,1618,0.031157739,0.618492009
"Missoula County, Montana",107320,104998,51456,2322,1021,0.021636228,0.520536713
"Yellowstone County, Montana",142348,139677,84622,2671,1276,0.018763874,0.405527299
"Douglas County, Nebraska",502032,465056,296680,36976,25484,0.073652676,0.409041655
"Lancaster County, Nebraska",278728,261129,190653,17599,9777,0.063140409,0.315989065
"Sarpy County, Nebraska",150467,142559,76534,7908,4523,0.052556374,0.491356909
"Clark County, Nevada",1865746,1462072,406326,403674,254756,0.216360641,0.782217944
"Washoe County, Nevada",410443,348692,115965,61751,39134,0.150449636,0.717463813
"Cheshire County, New Hampshire",77170,74713,31205,2457,702,0.031838797,0.595633018
"Grafton County, New Hampshire",85921,81821,36559,4100,2149,0.047718253,0.574504487
"Hillsborough County, New Hampshire",402042,370310,171372,31732,16276,0.078927077,0.573746027
"Merrimack County, New Hampshire",148161,143480,77718,4681,1727,0.031594009,0.475449005
"Rockingham County, New Hampshire",297350,286361,79319,10989,4468,0.036956449,0.733247015
"Strafford County, New Hampshire",121914,115767,60329,6147,2947,0.050420788,0.505151172
"Atlantic County, New Jersey",270681,234898,148863,35783,16104,0.132196201,0.45004267
"Bergen County, New Jersey",894840,630421,392463,264419,114248,0.295493049,0.561415449
"Burlington County, New Jersey",445475,405587,235840,39888,17025,0.089540378,0.470587575
"Camden County, New Jersey",517234,469378,271845,47856,23225,0.09252292,0.474425502
"Cape May County, New Jersey",95838,94467,47061,1371,548,0.01430539,0.508952608
"Cumberland County, New Jersey",156830,143681,103549,13149,9643,0.083842377,0.339737295
"Essex County, New Jersey",770675,595229,407922,175446,96318,0.227652383,0.47069517
"Gloucester County, New Jersey",287860,274689,163133,13171,3815,0.045754881,0.433290488
"Hudson County, New Jersey",595419,355888,233083,239531,127995,0.402289816,0.608539533
"Hunterdon County, New Jersey",129031,118207,80657,10824,3534,0.083886818,0.374902155
"Mercer County, New Jersey",364883,294443,192053,70440,41620,0.193048183,0.47365868
"Middlesex County, New Jersey",789102,566321,377760,222781,114395,0.282322184,0.521278618
"Monmouth County, New Jersey",642448,555544,351513,86904,45000,0.135270092,0.452853772
"Morris County, New Jersey",487548,394916,269507,92632,42360,0.189995652,0.447219556
"Ocean County, New Jersey",569111,524180,374748,44931,20372,0.078949449,0.341520371
"Passaic County, New Jersey",490948,375946,265212,115002,58085,0.234244767,0.459796149
"Salem County, New Jersey",66141,64042,42486,2099,1233,0.031735232,0.357645031
"Somerset County, New Jersey",324563,253973,171169,70590,34298,0.217492444,0.472617027
"Sussex County, New Jersey",150909,140025,100174,10884,2816,0.072122935,0.336195986
"Union County, New Jersey",523249,372541,263986,150708,83101,0.288023484,0.495486852
"Warren County, New Jersey",109876,100251,70339,9625,4650,0.087598748,0.359832903
"Bernalillo County, New Mexico",635139,562762,312775,72377,52308,0.113954583,0.507548741
"Dona Ana County, New Mexico",201603,165684,78249,35919,23561,0.178166992,0.611865895
"McKinley County, New Mexico",70724,69847,53635,877,638,0.012400317,0.241629433
"Sandoval County, New Mexico",122298,116177,59035,6121,2813,0.050049878,0.517285647
"San Juan County, New Mexico",122500,119377,74083,3123,2042,0.025493878,0.395240816
"Santa Fe County, New Mexico",143937,126940,70302,16997,13845,0.118086385,0.511577982
"Valencia County, New Mexico",67893,63281,41832,4612,3591,0.06793042,0.383854006
"Albany County, New York",298130,273922,226188,24208,11870,0.081199477,0.241310838
"Bronx County, New York",1391903,936605,740263,455298,260358,0.32710469,0.468164807
"Broome County, New York",195018,182874,145965,12144,4165,0.062271175,0.251530628
"Cattaraugus County, New York",79688,78646,64058,1042,505,0.013075996,0.196139946
"Cayuga County, New York",79823,78185,68072,1638,757,0.020520401,0.147213209
"Chautauqua County, New York",133789,131325,100583,2464,1220,0.01841706,0.248196787
"Chemung County, New York",87813,85396,67071,2417,1537,0.027524398,0.236206484
"Clinton County, New York",81947,78053,65340,3894,1915,0.047518518,0.202655375
"Dutchess County, New York",292878,261085,206029,31793,15315,0.108553732,0.296536442
"Erie County, New York",909845,861928,744895,47917,22690,0.052665014,0.181294616
"Jefferson County, New York",118046,114130,80520,3916,2565,0.033173509,0.317893025
"Kings County, New York",2556598,1618863,1316935,937735,411686,0.366790164,0.48488773
"Madison County, New York",69766,68336,57641,1430,463,0.02049709,0.173795258
"Monroe County, New York",732762,669929,543387,62833,27319,0.085748169,0.258439985
"Nassau County, New York",1351625,1070166,974449,281459,103945,0.208237492,0.279053732
"New York County, New York",1634795,1175824,716822,458971,249300,0.280751409,0.561521781
"Niagara County, New York",214464,203378,178748,11086,3458,0.051691659,0.166536109
"Oneida County, New York",231590,217559,190740,14031,6129,0.060585518,0.176389309
"Onondaga County, New York",452633,426455,348880,26178,13144,0.057834935,0.229221025
"Ontario County, New York",104475,101864,85543,2611,560,0.024991625,0.181210816
"Orange County, New York",379647,336238,263570,43409,22834,0.114340427,0.305749815
"Oswego County, New York",121395,119214,104851,2181,1122,0.017966144,0.136282384
"Putnam County, New York",99244,89698,75474,9546,3824,0.096187175,0.239510701
"Queens County, New York",2293007,1206421,1027449,1086586,507062,0.473869465,0.551920688
"Rensselaer County, New York",155261,148936,120790,6325,2751,0.040737854,0.222019696
"Richmond County, New York",487407,385181,349038,102226,40235,0.20973437,0.283888003
"Rockland County, New York",298545,237061,196985,61484,28669,0.205945502,0.340183222
"St. Lawrence County, New York",109701,104895,88785,4806,2765,0.043809993,0.190663713
"Saratoga County, New York",217191,208370,169000,8821,3973,0.040614022,0.221883043
"Schenectady County, New York",151427,137615,115237,13812,6437,0.091212267,0.238993046
"Steuben County, New York",96573,94331,74530,2242,1450,0.023215599,0.228252203
"Suffolk County, New York",1512224,1298638,1161939,213586,117628,0.141239658,0.231635657
"Sullivan County, New York",76189,67586,53980,8603,3903,0.112916563,0.291498773
"Tompkins County, New York",101136,89762,57440,11374,8400,0.112462427,0.432051891
"Ulster County, New York",181670,170410,138088,11260,6207,0.061980514,0.239896516
"Warren County, New York",65971,64038,53324,1933,292,0.029300753,0.191705446
"Wayne County, New York",91564,89690,76269,1874,756,0.020466559,0.167041632
"Westchester County, New York",953943,720377,586439,233566,124894,0.244842721,0.385247337
"Alamance County, North Carolina",148053,136352,97260,11701,7835,0.079032509,0.343073089
"Brunswick County, North Carolina",103160,99557,53500,3603,2078,0.034926328,0.481388135
"Buncombe County, North Carolina",229047,218076,120376,10971,8240,0.047898466,0.474448476
"Burke County, North Carolina",89361,85490,67984,3871,2532,0.043318674,0.239220689
"Cabarrus County, North Carolina",168740,157338,94743,11402,8363,0.067571412,0.438526728
"Caldwell County, North Carolina",80059,77739,60267,2320,1103,0.028978628,0.247217677
"Catawba County, North Carolina",157079,144163,102677,12916,10418,0.082226141,0.346335284
"Cleveland County, North Carolina",99015,96982,76904,2033,1439,0.020532243,0.2233096
"Craven County, North Carolina",96892,93632,48052,3260,2215,0.033645709,0.504066383
"Cumberland County, North Carolina",312696,297311,136450,15385,7222,0.049201141,0.563633689
"Davidson County, North Carolina",158166,151491,117357,6675,5061,0.042202496,0.258013732
"Durham County, North Carolina",262715,226339,124553,36376,28090,0.138461831,0.525900691
"Forsyth County, North Carolina",343028,315013,209965,28015,21313,0.081669718,0.38790711
"Gaston County, North Carolina",206679,196720,140366,9959,7185,0.048185834,0.320850207
"Guilford County, North Carolina",472216,434424,276287,37792,26227,0.080031172,0.414913938
"Harnett County, North Carolina",112030,105387,66596,6643,5027,0.059296617,0.405552084
"Henderson County, North Carolina",102367,95487,43259,6880,4226,0.067209159,0.577412643
"Iredell County, North Carolina",155359,148309,90682,7050,4917,0.045378768,0.416306748
"Johnston County, North Carolina",163428,149719,98274,13709,11799,0.083884035,0.398670974
"Lincoln County, North Carolina",74746,70341,50759,4405,3521,0.058932919,0.320913494
"Mecklenburg County, North Carolina",890515,773094,372470,117421,82400,0.131857408,0.581736411
"Moore County, North Carolina",85608,81467,46493,4141,3192,0.048371648,0.456908233
"Nash County, North Carolina",93674,89756,69601,3918,3001,0.041825907,0.256986997
"New Hanover County, North Carolina",192538,183747,101470,8791,5010,0.045658519,0.472987151
"Onslow County, North Carolina",165938,158890,61958,7048,3699,0.042473695,0.626619581
"Orange County, North Carolina",126532,111984,59225,14548,10591,0.114974868,0.531936585
"Pitt County, North Carolina",156081,148861,106011,7220,4608,0.046258033,0.320794972
"Randolph County, North Carolina",141186,130998,99990,10188,8028,0.072160129,0.291785304
"Robeson County, North Carolina",129123,122128,101184,6995,6382,0.054173153,0.216375084
"Rockingham County, North Carolina",92282,88839,70174,3443,2908,0.037309551,0.239570014
"Rowan County, North Carolina",139225,133212,97172,6013,4568,0.043189082,0.302050637
"Surry County, North Carolina",72468,68948,53267,3520,2993,0.048573163,0.264958326
"Union County, North Carolina",193255,177296,97096,15959,11614,0.082580011,0.497575742
"Wake County, North Carolina",866410,765353,382107,101057,65920,0.116638774,0.558976697
"Wayne County, North Carolina",113671,109340,75903,4331,3788,0.038101187,0.332257128
"Wilkes County, North Carolina",66655,65134,50648,1521,1273,0.022818993,0.240147026
"Wilson County, North Carolina",77527,73140,58102,4387,3572,0.056586738,0.25055787
"Burleigh County, North Dakota",78689,77191,60378,1498,419,0.019036968,0.232700886
"Cass County, North Dakota",139918,133126,79211,6792,4529,0.048542718,0.433875556
"Grand Forks County, North Dakota",66585,65369,40650,1216,758,0.018262371,0.38950214
"Allen County, Ohio",105168,104444,88006,724,180,0.006884223,0.163186521
"Ashtabula County, Ohio",100648,98866,77085,1782,1162,0.01770527,0.234112948
"Belmont County, Ohio",67975,67374,36258,601,338,0.008841486,0.466598014
"Butler County, Ohio",360765,346169,252095,14596,7887,0.04045847,0.301221016
"Clark County, Ohio",139859,137314,109022,2545,1151,0.018196898,0.220486347
"Clermont County, Ohio",195385,191771,146124,3614,2238,0.018496814,0.252122732
"Columbiana County, Ohio",107873,106918,85293,955,167,0.008853003,0.209320219
"Cuyahoga County, Ohio",1283925,1196053,941471,87872,37052,0.068440135,0.266724302
"Delaware County, Ohio",165026,156150,112974,8876,4321,0.053785464,0.315416965
"Erie County, Ohio",77062,76468,61416,594,180,0.007708079,0.203031325
"Fairfield County, Ohio",142223,138918,111330,3305,1805,0.023238154,0.217215218
"Franklin County, Ohio",1129067,1032921,751271,96146,62866,0.085155265,0.334609018
"Geauga County, Ohio",94753,92746,74564,2007,702,0.021181387,0.213069771
"Greene County, Ohio",159190,153973,100588,5217,2118,0.032772159,0.368126139
"Hamilton County, Ohio",851494,814280,623588,37214,20200,0.04370436,0.267654264
"Hancock County, Ohio",74273,70922,58115,3351,2915,0.045117337,0.217548773
"Jefferson County, Ohio",68526,66775,45726,1751,916,0.025552345,0.332720427
"Lake County, Ohio",234030,219806,177135,14224,6933,0.060778533,0.243109858
"Licking County, Ohio",157721,155563,123555,2158,1198,0.013682389,0.216623024
"Lorain County, Ohio",304373,296520,226832,7853,3509,0.02580058,0.254756499
"Lucas County, Ohio",440456,422855,334701,17601,8979,0.039960859,0.240103438
"Mahoning County, Ohio",237978,231679,187464,6299,2289,0.026468833,0.212263318
"Marion County, Ohio",65768,65139,55652,629,478,0.009563922,0.153813405
"Medina County, Ohio",171210,164205,130607,7005,3093,0.040914666,0.237153204
"Miami County, Ohio",101085,99447,78629,1638,758,0.016204185,0.222149676
"Montgomery County, Ohio",534626,516306,372913,18320,8634,0.034266945,0.302478742
"Muskingum County, Ohio",85087,84222,73815,865,457,0.010166065,0.132476171
"Portage County, Ohio",155991,150783,118924,5208,3181,0.033386542,0.237622683
"Richland County, Ohio",124999,122005,100422,2994,411,0.023952192,0.196617573
"Ross County, Ohio",76073,75617,63672,456,126,0.005994242,0.163014473
"Scioto County, Ohio",76587,75629,61862,958,793,0.01250865,0.192265006
"Stark County, Ohio",379214,372527,309551,6687,3000,0.017633843,0.183703661
"Summit County, Ohio",542562,520199,410595,22363,9006,0.041217409,0.243229345
"Trumbull County, Ohio",211317,208347,159687,2970,895,0.014054714,0.244324877
"Tuscarawas County, Ohio",91348,89986,79165,1362,977,0.014910014,0.133369094
"Warren County, Ohio",207353,198615,138989,8738,4511,0.042140697,0.32969863
"Wayne County, Ohio",113812,112854,93621,958,471,0.00841739,0.1774066
"Wood County, Ohio",125340,122969,100079,2371,1180,0.018916547,0.201539812
"Canadian County, Oklahoma",106079,100009,68157,6070,3056,0.057221505,0.357488287
"Cleveland County, Oklahoma",239760,225883,145693,13877,7738,0.057878712,0.392338172
"Comanche County, Oklahoma",111772,104996,45696,6776,3423,0.060623412,0.591167734
"Creek County, Oklahoma",69822,68915,48769,907,433,0.012990175,0.301523875
"Muskogee County, Oklahoma",71278,69444,52171,1834,1384,0.025730239,0.268063077
"Oklahoma County, Oklahoma",706617,643222,419872,63395,44654,0.089716211,0.405799747
"Payne County, Oklahoma",78280,73914,46311,4366,2961,0.055774144,0.408392948
"Pottawatomie County, Oklahoma",69616,68874,49704,742,434,0.010658469,0.286026201
"Rogers County, Oklahoma",84300,83213,52329,1087,949,0.012894425,0.379252669
"Tulsa County, Oklahoma",591982,547016,334591,44966,30471,0.075958391,0.434795315
"Wagoner County, Oklahoma",68960,67707,45632,1253,589,0.018169954,0.338283063
"Benton County, Oregon",81859,74642,34680,7217,3861,0.088163794,0.57634469
"Clackamas County, Oregon",380576,343402,201423,37174,20330,0.097678256,0.470741718
"Deschutes County, Oregon",158456,151219,67535,7237,4551,0.045671985,0.573793356
"Douglas County, Oregon",104059,102109,51082,1950,869,0.018739369,0.509105411
"Jackson County, Oregon",201138,189867,78717,11271,7567,0.056036154,0.608641828
"Josephine County, Oregon",81618,79193,27880,2425,1078,0.029711583,0.658408684
"Klamath County, Oregon",64854,62850,30915,2004,898,0.030900176,0.523313905
"Lane County, Oregon",346560,328078,154855,18482,11836,0.053329871,0.553165397
"Linn County, Oregon",115348,110787,62081,4561,2282,0.039541214,0.461793876
"Marion County, Oregon",314606,271569,154063,43037,32164,0.136796501,0.510298596
"Multnomah County, Oregon",714567,615625,309837,98942,62139,0.138464273,0.566398952
"Polk County, Oregon",77074,72872,41955,4202,2354,0.054519034,0.455653009
"Umatilla County, Oregon",73526,67845,31782,5681,4135,0.077265185,0.567744743
"Washington County, Oregon",529216,438943,225258,90273,58144,0.170578743,0.574355273
"Yamhill County, Oregon",98168,89262,48488,8906,6564,0.090722028,0.506071225
"Adams County, Pennsylvania",101119,97897,60014,3222,2153,0.031863448,0.406501251
"Allegheny County, Pennsylvania",1215103,1161902,972226,53201,26844,0.04378312,0.199881821
"Armstrong County, Pennsylvania",68790,67869,63396,921,556,0.013388574,0.07841256
"Beaver County, Pennsylvania",172476,169491,144815,2985,823,0.017306756,0.160375936
"Berks County, Pennsylvania",403595,380725,308613,22870,12829,0.056665717,0.235339883
"Blair County, Pennsylvania",125174,123943,111969,1231,864,0.009834311,0.105493154
"Bucks County, Pennsylvania",621643,572388,434689,49255,22734,0.079233579,0.300741744
"Butler County, Pennsylvania",182902,178895,150957,4007,2065,0.021907907,0.174656373
"Cambria County, Pennsylvania",144319,143043,128953,1276,443,0.008841525,0.106472467
"Centre County, Pennsylvania",144779,134896,104749,9883,6700,0.068262662,0.276490375
"Chester County, Pennsylvania",491489,451145,311653,40344,24448,0.082085255,0.365900356
"Clearfield County, Pennsylvania",82896,82045,73995,851,410,0.010265875,0.107375507
"Columbia County, Pennsylvania",65004,63390,52386,1614,1112,0.024829241,0.194111132
"Crawford County, Pennsylvania",88411,87625,72077,786,492,0.008890296,0.184750766
"Cumberland County, Pennsylvania",229361,218458,168627,10903,5127,0.047536416,0.264796543
"Dauphin County, Pennsylvania",256562,242668,193163,13894,6532,0.054154551,0.24710986
"Delaware County, Pennsylvania",553619,508905,412456,44714,22694,0.080766737,0.254982217
"Erie County, Pennsylvania",279175,269279,226378,9896,5310,0.0354473,0.189117937
"Fayette County, Pennsylvania",143925,143075,123993,850,403,0.005905854,0.138488796
"Franklin County, Pennsylvania",143495,138923,95497,4572,2592,0.031861737,0.334492491
"Indiana County, Pennsylvania",87479,85864,74475,1615,769,0.018461574,0.14865282
"Lackawanna County, Pennsylvania",209408,202222,166473,7186,4715,0.034315785,0.205030371
"Lancaster County, Pennsylvania",502370,483458,392359,18912,9669,0.03764556,0.218984016
"Lawrence County, Pennsylvania",90272,89236,76342,1036,317,0.011476427,0.154311414
"Lebanon County, Pennsylvania",128934,124492,103080,4442,2709,0.034451735,0.200521197
"Lehigh County, Pennsylvania",339989,307905,220768,32084,16914,0.094367759,0.350661345
"Luzerne County, Pennsylvania",311983,301111,253408,10872,6027,0.034848053,0.187750615
"Lycoming County, Pennsylvania",116670,115014,98063,1656,518,0.01419388,0.159484015
"Mercer County, Pennsylvania",116652,114889,93607,1763,606,0.015113329,0.197553407
"Monroe County, Pennsylvania",165058,148176,59641,16882,6384,0.102279199,0.638666408
"Montgomery County, Pennsylvania",778048,709284,554786,68764,31411,0.088380151,0.286951448
"Northampton County, Pennsylvania",294787,275813,177886,18974,9414,0.064365118,0.396560907
"Northumberland County, Pennsylvania",91091,90171,79984,920,362,0.01009979,0.121933012
"Philadelphia County, Pennsylvania",1447395,1296106,1011144,151289,80959,0.104525026,0.301404247
"Schuylkill County, Pennsylvania",147254,144168,129374,3086,1802,0.020956986,0.121422848
"Somerset County, Pennsylvania",77454,76580,67443,874,252,0.011284117,0.12925091
"Washington County, Pennsylvania",206407,203474,175491,2933,550,0.014209789,0.149781742
"Westmoreland County, Pennsylvania",361589,355574,318972,6015,1870,0.016634909,0.117860333
"York County, Pennsylvania",424583,409341,276378,15242,8245,0.035898752,0.349060137
"Kent County, Rhode Island",168058,159597,120338,8461,2792,0.050345714,0.283949589
"Newport County, Rhode Island",80478,76111,30215,4367,1019,0.054263277,0.624555779
"Providence County, Rhode Island",626150,519710,367183,106440,58620,0.169991216,0.413586201
"Washington County, Rhode Island",126264,120830,75742,5434,1838,0.043036812,0.400129887
"Aiken County, South Carolina",154071,149429,68848,4642,2850,0.030128967,0.553141084
"Anderson County, South Carolina",182825,177090,128628,5735,2976,0.031368795,0.296441953
"Beaufort County, South Carolina",150415,137108,42949,13307,9859,0.08846857,0.714463318
"Berkeley County, South Carolina",169327,161170,91580,8157,4139,0.048173062,0.459153
"Charleston County, South Carolina",348046,332000,191231,16046,9782,0.046103101,0.45055826
"Darlington County, South Carolina",67031,66350,56311,681,142,0.010159478,0.159926004
"Dorchester County, South Carolina",127133,121978,64349,5155,3252,0.040548087,0.493845028
"Florence County, South Carolina",132800,130587,99061,2213,1380,0.016664157,0.254058735
"Greenville County, South Carolina",438119,403178,240535,34941,24512,0.079752305,0.450982496
"Greenwood County, South Carolina",68549,65989,49053,2560,2190,0.037345548,0.284409692
"Horry County, South Carolina",257380,242134,102245,15246,10180,0.059235372,0.602746911
"Lancaster County, South Carolina",75913,73448,49979,2465,2391,0.032471382,0.341627916
"Laurens County, South Carolina",69681,68202,55150,1479,610,0.021225298,0.208536043
"Lexington County, South Carolina",248518,237775,151914,10743,7004,0.043228257,0.388720334
"Oconee County, South Carolina",71274,68370,41420,2904,1871,0.04074417,0.418862418
"Orangeburg County, South Carolina",90336,88694,70717,1642,1206,0.018176585,0.217178091
"Pickens County, South Carolina",116915,113420,75024,3495,2537,0.029893512,0.358303041
"Richland County, South Carolina",364001,345649,211540,18352,10886,0.050417444,0.41884775
"Spartanburg County, South Carolina",280738,266077,186213,14661,9372,0.052223069,0.336701836
"Sumter County, South Carolina",104148,101341,67237,2807,1275,0.02695203,0.35440911
"York County, South Carolina",217448,208878,96212,8570,4771,0.039411721,0.557540194
"Minnehaha County, South Dakota",179180,172356,113078,6824,4035,0.038084608,0.368913941
"Pennington County, South Dakota",98533,96949,58590,1584,606,0.016075832,0.405376879
"Anderson County, Tennessee",74169,72659,49480,1510,578,0.02035891,0.332874921
"Blount County, Tennessee",121511,118884,82373,2627,2189,0.021619442,0.322094296
"Bradley County, Tennessee",96472,94165,58780,2307,1704,0.023913674,0.390704038
"Davidson County, Tennessee",626144,556534,343257,69610,47714,0.11117251,0.451792239
"Greene County, Tennessee",66911,65884,47864,1027,565,0.015348747,0.284661715
"Hamilton County, Tennessee",332848,319081,195528,13767,8212,0.041361222,0.412560688
"Knox County, Tennessee",430019,414578,269024,15441,9608,0.035907716,0.374390434
"Madison County, Tennessee",96376,93327,67771,3049,2315,0.031636507,0.296806259
"Maury County, Tennessee",81938,79964,47874,1974,1370,0.024091386,0.415728966
"Montgomery County, Tennessee",154756,148295,55985,6461,2744,0.041749593,0.638236967
"Putnam County, Tennessee",71160,67986,46248,3174,2330,0.04460371,0.350084317
"Rutherford County, Tennessee",249270,234091,134894,15179,10311,0.06089381,0.458843824
"Sevier County, Tennessee",84835,82162,43747,2673,2133,0.031508222,0.484328402
"Shelby County, Tennessee",906825,859807,559630,47018,33041,0.051849034,0.3828688
"Sullivan County, Tennessee",153900,151834,92267,2066,1050,0.013424301,0.400474334
"Sumner County, Tennessee",155474,150766,88318,4708,2936,0.03028159,0.431943605
"Washington County, Tennessee",118639,114565,73989,4074,3256,0.034339467,0.37635179
"Williamson County, Tennessee",171452,161570,73376,9882,6023,0.057637123,0.572031822
"Wilson County, Tennessee",109803,107967,71341,1836,825,0.016720855,0.350281868
"Angelina County, Texas",83038,76726,63387,6312,4763,0.076013391,0.23665069
"Bastrop County, Texas",71776,63947,46227,7829,5721,0.109075457,0.355954637
"Bell County, Texas",285084,261383,135676,23701,12608,0.0831369,0.52408413
"Bexar County, Texas",1622899,1429347,1041771,193552,115710,0.119263121,0.358080201
"Bowie County, Texas",92283,89586,59524,2697,1218,0.029225318,0.354984125
"Brazoria County, Texas",301044,265846,193281,35198,21223,0.116919786,0.357964284
"Brazos County, Texas",175122,152486,122565,22636,19035,0.12925846,0.30011649
"Cameron County, Texas",392736,297142,252522,95594,61916,0.243405239,0.357018455
"Collin County, Texas",762010,623205,342067,138805,83160,0.182156402,0.551099067
"Comal County, Texas",109635,101631,71277,8004,5446,0.073005883,0.349870023
"Coryell County, Texas",72654,68675,32383,3979,1879,0.054766427,0.554284692
"Dallas County, Texas",2412827,1839085,1326807,573742,436816,0.237788287,0.450102722
"Denton County, Texas",636557,549635,313088,86922,56594,0.136550223,0.508154022
"Ector County, Texas",131941,117959,96111,13982,8296,0.105971609,0.271560773
"Ellis County, Texas",148186,136824,105244,11362,8954,0.07667391,0.28978446
"El Paso County, Texas",742062,539280,409225,202782,117559,0.273268271,0.448529907
"Fort Bend County, Texas",532141,407413,275905,124728,65428,0.234389006,0.481518996
"Galveston County, Texas",288239,261020,184143,27219,17950,0.094432051,0.361144744
"Grayson County, Texas",118804,112387,78626,6417,4744,0.054013333,0.338187266
"Gregg County, Texas",117528,107382,76330,10146,7253,0.086328364,0.350537744
"Guadalupe County, Texas",117172,109656,73567,7516,3023,0.064145018,0.372145222
"Harris County, Texas",3984349,2995986,2120378,988363,685660,0.248061352,0.467823225
"Hays County, Texas",149476,139590,103222,9886,6254,0.066137708,0.30944098
"Henderson County, Texas",78814,74728,57260,4086,2317,0.051843581,0.273479331
"Hidalgo County, Texas",726604,514503,438162,212101,162515,0.291907284,0.396972766
"Hunt County, Texas",82805,77866,59784,4939,4120,0.059646157,0.278014613
"Jefferson County, Texas",243090,222037,173324,21053,13714,0.086605784,0.286996586
"Johnson County, Texas",153630,144258,108835,9372,7011,0.06100371,0.291577166
"Kaufman County, Texas",100527,94183,72387,6344,4824,0.063107424,0.279924796
"Liberty County, Texas",75333,71276,54909,4057,3214,0.053854221,0.271116244
"Lubbock County, Texas",264418,254105,204599,10313,6282,0.03900264,0.226228925
"McLennan County, Texas",230213,212262,168550,17951,12061,0.077975614,0.267851946
"Midland County, Texas",129494,117890,91632,11604,7520,0.089610329,0.292384203
"Montgomery County, Texas",429953,380814,250241,49139,37132,0.114289236,0.41798057
"Nueces County, Texas",322077,301301,238981,20776,12238,0.064506314,0.258000416
"Orange County, Texas",83022,81086,60507,1936,1547,0.02331912,0.271193178
"Parker County, Texas",111776,107678,70816,4098,2927,0.036662611,0.36644718
"Potter County, Texas",120918,109197,80680,11721,8914,0.096933459,0.332770969
"Randall County, Texas",114546,111165,80753,3381,1736,0.029516526,0.295016849
"Rockwall County, Texas",77633,69088,43779,8545,7097,0.110069172,0.436077441
"San Patricio County, Texas",68399,65696,49875,2703,1815,0.039518122,0.270822673
"Smith County, Texas",201277,183411,139923,17866,13340,0.088763247,0.304823701
"Tarrant County, Texas",1750091,1478955,957643,271136,184940,0.154926801,0.452803883
"Taylor County, Texas",126791,121633,85954,5158,3412,0.040681121,0.32208122
"Tom Green County, Texas",107864,101467,77951,6397,3180,0.059306163,0.277321442
"Travis County, Texas",998543,815800,525495,182743,132677,0.183009645,0.473738237
"Victoria County, Texas",86755,82022,71704,4733,2944,0.054555933,0.17348856
"Webb County, Texas",236941,172960,157186,63981,42890,0.270029248,0.336602783
"Wichita County, Texas",127321,119264,79137,8057,4905,0.063280998,0.378445033
"Williamson County, Texas",394193,356904,209060,37289,23816,0.094595794,0.469650653
"Cache County, Utah",112616,106003,74234,6613,4294,0.058721674,0.340821908
"Davis County, Utah",295332,282268,189893,13064,6678,0.044234963,0.357018542
"Salt Lake County, Utah",1022651,894378,611048,128273,86411,0.125431843,0.402486283
"Utah County, Utah",530837,494368,318703,36469,25943,0.068700938,0.399621729
"Washington County, Utah",137589,128952,77879,8637,5768,0.062773914,0.433973646
"Weber County, Utah",227487,211819,144722,15668,12092,0.068874265,0.363822988
"Chittenden County, Vermont",152782,142581,77384,10201,4443,0.066768337,0.493500543
"Albemarle County, Virginia",94075,86871,45857,7204,4258,0.076577199,0.512548499
"Arlington County, Virginia",209969,160738,40600,49231,28858,0.234467945,0.806638123
"Augusta County, Virginia",70634,69035,48549,1599,563,0.022637823,0.31266812
"Bedford County, Virginia",65805,64307,45291,1498,763,0.022764228,0.31173923
"Chesterfield County, Virginia",303469,281476,175262,21993,12700,0.072471982,0.422471488
"Fairfax County, Virginia",1015302,729954,253100,285348,143288,0.281047412,0.750714566
"Fauquier County, Virginia",66408,63311,37191,3097,2111,0.046635947,0.439962053
"Frederick County, Virginia",73898,70292,42592,3606,2137,0.04879699,0.423637987
"Hanover County, Virginia",99716,96773,66421,2943,1207,0.029513819,0.333898271
"Henrico County, Virginia",292599,265763,173726,26836,14581,0.091715966,0.406265913
"Loudoun County, Virginia",289995,234732,96852,55263,29295,0.190565355,0.666021828
"Montgomery County, Virginia",89967,83843,47728,6124,3177,0.068069403,0.46949437
"Prince William County, Virginia",364734,291728,119578,73006,41839,0.20016231,0.672150115
"Roanoke County, Virginia",90867,85193,52823,5674,3073,0.062442911,0.418677848
"Rockingham County, Virginia",74394,70735,51442,3659,2955,0.049184074,0.308519504
"Spotsylvania County, Virginia",120031,112780,57043,7251,3184,0.060409394,0.524764436
"Stafford County, Virginia",121736,109476,43577,12260,7486,0.100709733,0.642036867
"Alexandria city, Virginia",143885,110173,34301,33712,19628,0.234298224,0.761608229
"Chesapeake city, Virginia",220111,212120,120594,7991,3949,0.03630441,0.452121884
"Hampton city, Virginia",145494,139245,73885,6249,2277,0.042950225,0.492178372
"Lynchburg city, Virginia",73839,70441,43807,3398,2898,0.046019041,0.406722735
"Newport News city, Virginia",179614,167046,83002,12568,7221,0.069972274,0.537886802
"Norfolk city, Virginia",234220,220341,119671,13879,8308,0.059256255,0.489065836
"Portsmouth city, Virginia",100577,98299,61559,2278,1249,0.022649313,0.387941577
"Richmond city, Virginia",202002,189342,130466,12660,9781,0.062672647,0.354135108
"Roanoke city, Virginia",92967,87726,60476,5241,3053,0.056374843,0.349489604
"Suffolk city, Virginia",82302,79884,53536,2418,712,0.029379602,0.34951763
"Virginia Beach city, Virginia",433746,398799,163599,34947,12779,0.080570195,0.622823035
"Benton County, Washington",163058,149036,78730,14022,9506,0.085993941,0.517165671
"Chelan County, Washington",71540,64154,39487,7386,5150,0.103242941,0.448043053
"Clallam County, Washington",71021,67534,34749,3487,2031,0.049098154,0.510722181
"Clark County, Washington",424733,380964,130616,43769,24792,0.103050622,0.692475037
"Cowlitz County, Washington",101254,95831,55127,5423,4418,0.053558378,0.455557311
"Franklin County, Washington",72783,53576,35357,19207,15046,0.263894041,0.514213484
"Grant County, Washington",84697,72351,46980,12346,9694,0.145766674,0.445316835
"Grays Harbor County, Washington",71342,68266,45240,3076,2126,0.043116257,0.365871436
"Island County, Washington",81424,75855,28615,5569,1888,0.068395068,0.64856799
"King County, Washington",1875519,1508055,778401,367464,192382,0.195926568,0.584967681
"Kitsap County, Washington",239769,226636,104875,13133,4482,0.054773553,0.562599836
"Lewis County, Washington",74132,70232,41854,3900,2547,0.05260886,0.435412507
"Pierce County, Washington",785639,716790,390333,68849,33911,0.087634397,0.50316494
"Skagit County, Washington",118000,104555,65687,13445,9392,0.113940678,0.443330508
"Snohomish County, Washington",683655,593496,356106,90159,48054,0.131877921,0.479114466
"Spokane County, Washington",462677,439436,237558,23241,12769,0.050231587,0.486557577
"Thurston County, Washington",245181,228232,113343,16949,8006,0.069128521,0.537717034
"Whatcom County, Washington",196529,176337,99317,20192,11849,0.102743107,0.494644556
"Yakima County, Washington",234564,196664,137816,37900,28562,0.161576371,0.41245886
"Berkeley County, West Virginia",102044,100002,41479,2042,1405,0.020010976,0.593518482
"Cabell County, West Virginia",94631,93510,72541,1121,801,0.011846012,0.233433019
"Harrison County, West Virginia",68853,68039,54552,814,547,0.011822288,0.207703368
"Kanawha County, West Virginia",191018,187084,152026,3934,1091,0.020594918,0.20412736
"Monongalia County, West Virginia",88221,84679,53776,3542,2489,0.040149171,0.390439918
"Raleigh County, West Virginia",79357,78609,59780,748,382,0.00942576,0.246695314
"Wood County, West Virginia",86204,85365,65056,839,699,0.009732727,0.245325043
"Brown County, Wisconsin",245018,232482,184427,12536,8500,0.051163588,0.247292036
"Dane County, Wisconsin",482705,450027,311208,32678,19887,0.067697662,0.355283248
"Dodge County, Wisconsin",87912,85457,71345,2455,1535,0.027925653,0.188449813
"Eau Claire County, Wisconsin",98286,95058,68958,3228,2176,0.032842928,0.298394481
"Fond du Lac County, Wisconsin",99453,96451,81542,3002,2247,0.030185113,0.18009512
"Jefferson County, Wisconsin",80792,77394,62967,3398,2625,0.04205862,0.22062828
"Kenosha County, Wisconsin",164465,154482,80081,9983,5551,0.060699845,0.513081811
"La Crosse County, Wisconsin",112627,109098,80352,3529,2038,0.031333517,0.286565388
"Manitowoc County, Wisconsin",80641,78532,66430,2109,1109,0.026152949,0.176225493
"Marathon County, Wisconsin",130962,126594,103243,4368,2487,0.033353186,0.211656816
"Milwaukee County, Wisconsin",953328,872359,659466,80969,50004,0.084932993,0.308248578
"Outagamie County, Wisconsin",174993,168830,141222,6163,3108,0.035218552,0.192984862
"Ozaukee County, Wisconsin",85874,82283,63287,3591,1194,0.041817081,0.263024897
"Portage County, Wisconsin",68744,66232,54185,2512,953,0.036541371,0.211785756
"Racine County, Wisconsin",199510,192571,145069,6939,4230,0.034780212,0.27287354
"Rock County, Wisconsin",160213,152391,115497,7822,4872,0.048822505,0.279103444
"St. Croix County, Wisconsin",82487,80889,34928,1598,546,0.01937275,0.57656358
"Sheboygan County, Wisconsin",114561,110073,91010,4488,2467,0.039175636,0.205576069
"Walworth County, Wisconsin",100749,93039,56080,7710,3822,0.076526814,0.443369165
"Washington County, Wisconsin",129477,125214,106943,4263,2065,0.032924767,0.174038632
"Waukesha County, Wisconsin",380629,364453,289456,16176,7435,0.042498076,0.239532458
"Winnebago County, Wisconsin",162111,158020,132224,4091,2762,0.025235795,0.184361333
"Wood County, Wisconsin",73756,72231,60116,1525,724,0.020676284,0.184934107
"Laramie County, Wyoming",87542,84654,35340,2888,1201,0.032989879,0.596308058
"Natrona County, Wyoming",73129,72141,34807,988,338,0.013510372,0.524032873
